1111111111111
10000000000E1
1000CE1111111
1101000000C01
1P01000000001
1111111111111
