1111111111111
1011100000001
1000C01111C11
1P0011E000C01
1011100000001
1111111111111
