1111111111111
1011100000001
1000C01111011
1P0011E000001
1111111111111
