1111111
1E00001
1000001
1011101
101C001
101C001
1010001
1010001
1P10001
1111111
